37
0 3 42 42 42 42 42 42
1 3 42 42 42 42 42 42
2 3 42 42 42 42 42 42
3 3 42 42 42 42 42 42
4 3 42 42 42 42 42 42
5 3 42 42 42 42 42 42
6 3 42 42 42 42 42 42
7 2 42 42 42 42 42 42
8 2 42 42 42 42 42 42
9 2 42 42 42 42 42 42
10 2 42 42 42 42 42 42
11 2 42 42 42 42 42 42
12 2 42 42 42 42 42 42
13 2 42 42 42 42 42 42
14 2 42 42 42 42 42 42
15 2 42 42 42 42 42 42
16 2 42 42 42 42 42 42
17 2 42 42 42 42 42 42
18 2 42 42 42 42 42 42
19 1 42 42 42 42 42 42
20 0 42 42 42 42 42 42
21 1 42 42 42 42 42 42
22 0 42 42 42 42 42 42
23 1 42 42 42 42 42 42
24 1 42 42 42 42 42 42
25 0 42 42 42 42 42 42
26 1 42 42 42 42 42 42
27 1 42 42 42 42 42 42
28 1 42 42 42 42 42 42
29 0 42 42 42 42 42 42
30 1 42 42 42 42 42 42
31 0 42 42 42 42 42 42
32 1 42 42 42 42 42 42
33 1 42 42 42 42 42 42
34 0 42 42 42 42 42 42
35 1 42 42 42 42 42 42
36 1 42 42 42 42 42 42
23
12
60 0
16 156 0
21
2 0 0 0
3 0 1 0
4 1 1 0
5 3 0 0
6 2 0 0
9 2 0 0
10 1 1 0
11 1 1 0
12 0 1 0
13 3 1 0
14 0 1 0
17 1 0 0
18 1 0 0
19 2 0 0
21 2 0 0
23 2 0 0
24 1 1 0
26 0 1 0
28 1 1 0
32 1 0 0
33 2 0 0
19
WAIT
COMPLETE 13
GROW 10
GROW 11
GROW 24
GROW 26
GROW 14
GROW 4
GROW 3
GROW 28
GROW 12
SEED 13 30
SEED 13 0
SEED 4 0
SEED 13 1
SEED 13 16
SEED 28 27
SEED 13 27
SEED 13 15